11111111111111111111111111111111111111111
10000000000000001000000000000010000000001
10000000000000001000000000000010000000001
10000000000000001000001000000010000000001
11111001111100001000001000000010000000001
10000000000100001000001111100010000000001
10000000000100001000001000000010000000001
10000000000100000000001000000010000000001
11111001111100000000001001111110000000001
10000000000110011111111000000010000000001
10000000000100000000001000100010000000001
10000000000100000000001000100010000000001
11111100111111111001111111100010000000001
10000000000000000000000000100010000000001
10000000000000000000000000000000000000001
10000000000000000000000000000000000000001
10000000000000000000000000000000000111111
10000011111111111110001111100010000000001
10000010000000000010001000100010000000001
10000010000100000010001000100010000100001
1000000000010000000000000000001N000100001
11111111111111111111111111111111111111111
