NO ./walls/eagle.xpm
SO ./walls/bluestone.xpm
WE ./walls/redbrick.xpm
EA ./walls/shinybrick.xpm
DO ./walls/door101.xpm
FL ./walls/colorstone.xpm
CL ./walls/Elements.xpm
F 220,100,0
C 225,30,0

11111111111111111111111111111111111111111
10000000000000001000000000000000000000001
10000000000000001000000000000000000000001
1000000000000000111X111000000010000000001
11111001111100001000001000000010000000001
10000000000100001000001111100011110011111
1000000000010000100N00X000000010000000001
1000000000010000X000001000000010000000001
111111X1111100001000001001111110000000001
10000000000110011110111000000010000000001
10000000000100000000001000100010000000001
10000000000100000000001000100011111X11111
11111100111111111001111111100010000000001
10000000000000000000000000100010000000001
100000000000000000000000000000X0000000001
10000000000000000000000000000010000000001
10000000000000000000000000000010000111111
10000011111111111110001111100010000000001
10000010000000000010001000100010000000001
10000010000100000010001000100010000100001
10000000000100000000000000000010000100001
11111111111111111111111111111111111111111
