NO ./walls/eagle.xpm
SO ./walls/bluestone.xpm
WE ./walls/redbrick.xpm
EA ./walls/shinybrick.xpm
DO ./walls/doorskin.xpm
FL ./walls/colorstone.xpm
CL ./walls/Elements.xpm
F 220,100,0
C 225,30,0

1111111111
1000000001
1000000001
1000000001
1000002221
100E002001
1000002001
1000002001
1000002201
1000000001
1111111111